"filename", "language", "C++", "Markdown", "GLSL", "Batch", "comment", "blank", "total"
"d:\Projects\Thesis\README.md", "Markdown", 0, 1, 0, 0, 0, 1, 2
"d:\Projects\Thesis\src\app\application.cpp", "C++", 181, 0, 0, 0, 6, 25, 212
"d:\Projects\Thesis\src\app\application.h", "C++", 77, 0, 0, 0, 5, 11, 93
"d:\Projects\Thesis\src\main.cpp", "C++", 13, 0, 0, 0, 0, 0, 13
"d:\Projects\Thesis\src\memory_mger.h", "C++", 27, 0, 0, 0, 5, 9, 41
"d:\Projects\Thesis\src\pch.h", "C++", 3, 0, 0, 0, 0, 1, 4
"d:\Projects\Thesis\src\sdl\sdl_base.cpp", "C++", 135, 0, 0, 0, 0, 15, 150
"d:\Projects\Thesis\src\sdl\sdl_base.h", "C++", 22, 0, 0, 0, 0, 4, 26
"d:\Projects\Thesis\src\thesis.h", "C++", 6, 0, 0, 0, 0, 3, 9
"d:\Projects\Thesis\src\vk\shaders\compile_shaders.bat", "Batch", 0, 0, 0, 3, 0, 0, 3
"d:\Projects\Thesis\src\vk\shaders\triangle.frag", "GLSL", 0, 0, 7, 0, 0, 2, 9
"d:\Projects\Thesis\src\vk\shaders\triangle.vert", "GLSL", 0, 0, 9, 0, 0, 3, 12
"d:\Projects\Thesis\src\vk\vulkan_base.h", "C++", 164, 0, 0, 0, 4, 29, 197
"d:\Projects\Thesis\src\vk\vulkan_commands.cpp", "C++", 120, 0, 0, 0, 0, 12, 132
"d:\Projects\Thesis\src\vk\vulkan_device.cpp", "C++", 335, 0, 0, 0, 1, 60, 396
"d:\Projects\Thesis\src\vk\vulkan_instance.cpp", "C++", 194, 0, 0, 0, 19, 17, 230
"d:\Projects\Thesis\src\vk\vulkan_pipeline.cpp", "C++", 283, 0, 0, 0, 11, 42, 336
"d:\Projects\Thesis\tests\test1\Test.cpp", "C++", 5, 0, 0, 0, 0, 1, 6
"Total", "-", 1565, 1, 16, 3, 51, 235, 1871